##  ######  ######
#        #      X#
#          -    -#
#&       #    *  #
#          -     #
#                #
#                #
#             -  #
#                #
#   #            #
#   #    #   -   Y
##  ##  ##  ##   #