##################
#                #
#&               #
####^^-          #
#**-## ^^*   ^   #
#*--## ##   ^^^  #
##################
#        #     **#
#        #       #
#                #
# X  ^^^   ^     #
###############**#