####  ############
#   &            #
#X      -        #
#     ^^ ^^      #
#         ^*^^   #
#            ^^  #
#              - #
#          ^     #
#         ^^^    #
#       - ### *  #
#^^ ^^^    #     #
#######-**--***--#