#  *     -
#              & #
#                #
#-               #
#                #
#                #
#   -      *     #
#                #
#              - #
#                #
#     X          #
#     -      *   #