##################
#                #
#Y          &    #
#*               #
#     #-         #
#     # ^      ###
#^^^ ^   ^    -  #
###**#    #      #
#    -    *     *#
#    -         ^ #
#  X ^      ^   ##
###---############