
#                #
#       --     & #
#**              #
#                #
#                #
#    --          #
#                #
#**        **    #
#   *            #
#Y  *          X #
#*             --#