##################
#                #
#& **            #
#                #
#      ****** ---#
#                #
#                #
# ---         ***#
#                #
#       ---      #
# X              #
##################