##################
#                #
#       #   #    #
#       #---#    #
#  ***  #   #    #
#       #***#    #
######  #   # &  #
#       #---#    #
#  -    #   #    #
#  -    #***#    #
#YX-             #
##################